TABLE:DR$ESG_DOCS_TEXT_IDX$B	internal
TABLE:DR$ESG_DOCS_TEXT_IDX$C	internal
TABLE:DR$ESG_DOCS_TEXT_IDX$I	internal
TABLE:DR$ESG_DOCS_TEXT_IDX$K	internal
TABLE:DR$ESG_DOCS_TEXT_IDX$N	internal
TABLE:DR$ESG_DOCS_TEXT_IDX$Q	internal
TABLE:DR$ESG_DOCS_TEXT_IDX$U	internal
TABLE:DR$X_ESG_NEWS_TEXT_FT$B	internal
TABLE:DR$X_ESG_NEWS_TEXT_FT$C	internal
TABLE:DR$X_ESG_NEWS_TEXT_FT$I	internal,ddl_hits=21
TABLE:DR$X_ESG_NEWS_TEXT_FT$K	internal,ddl_hits=6
TABLE:DR$X_ESG_NEWS_TEXT_FT$N	internal,ddl_hits=9
TABLE:DR$X_ESG_NEWS_TEXT_FT$Q	internal
TABLE:DR$X_ESG_NEWS_TEXT_FT$U	internal,ddl_hits=6
TABLE:DR$X_ESG_NEWS_TITLE_FT$B	internal
TABLE:DR$X_ESG_NEWS_TITLE_FT$C	internal
TABLE:DR$X_ESG_NEWS_TITLE_FT$I	internal,ddl_hits=21
TABLE:DR$X_ESG_NEWS_TITLE_FT$K	internal,ddl_hits=6
TABLE:DR$X_ESG_NEWS_TITLE_FT$N	internal,ddl_hits=9
TABLE:DR$X_ESG_NEWS_TITLE_FT$Q	internal
TABLE:DR$X_ESG_NEWS_TITLE_FT$U	internal,ddl_hits=6
TABLE:DR$X_NEWS_ITEMS_FT$B	internal
TABLE:DR$X_NEWS_ITEMS_FT$C	internal
TABLE:DR$X_NEWS_ITEMS_FT$I	internal,ddl_hits=21
TABLE:DR$X_NEWS_ITEMS_FT$K	internal,ddl_hits=6
TABLE:DR$X_NEWS_ITEMS_FT$N	internal,ddl_hits=9
TABLE:DR$X_NEWS_ITEMS_FT$Q	internal
TABLE:DR$X_NEWS_ITEMS_FT$U	internal,ddl_hits=6
TABLE:DR$X_NEWS_ITEMS_SUMMARY_FT$B	internal
TABLE:DR$X_NEWS_ITEMS_SUMMARY_FT$C	internal
TABLE:DR$X_NEWS_ITEMS_SUMMARY_FT$I	internal,ddl_hits=21
TABLE:DR$X_NEWS_ITEMS_SUMMARY_FT$K	internal,ddl_hits=6
TABLE:DR$X_NEWS_ITEMS_SUMMARY_FT$N	internal,ddl_hits=9
TABLE:DR$X_NEWS_ITEMS_SUMMARY_FT$Q	internal
TABLE:DR$X_NEWS_ITEMS_SUMMARY_FT$U	internal,ddl_hits=6
TABLE:SC_IDX_DIVISOR	runtime_hits=7
TABLE:SC_IDX_HOLDINGS	runtime_hits=7
TABLE:SC_IDX_JOB_RUNS	runtime_hits=9
TABLE:SC_IDX_LEVELS	runtime_hits=8
TABLE:SC_IDX_PRICES_CANON	runtime_hits=13
TABLE:SC_IDX_PRICES_RAW	runtime_hits=17
TABLE:VECTOR$ESG_DOCS_HNSW$165913_172112_0$HNSW_CHECKPOINTS	internal,ddl_hits=18
TABLE:VECTOR$ESG_DOCS_HNSW$165913_172112_0$HNSW_SHARED_JOURNAL_CHANGE_LOG	internal,ddl_hits=27
TABLE:VECTOR$ESG_DOCS_HNSW$165913_172112_2$HNSW_ROWID_VID_MAP	internal
VIEW:V_NEWS_RECENT	runtime_hits=4,ddl_hits=6
